###############################################################################
######....###############.....################........##....*..##########....##
####...........................................*..............................#
##.......$......................**........................$$...=..=.=.==......#
#....*.......####...........$$..........*.*.......++....*.....=.==..==..*....##
##.........#######..........$...............$$...+==+..........=.=++=.=..$$.###
##..........##+###...*.......................$....++..........=..+++..=.....###
##..*........+++................................................++++.........##
##........*......$$...........##.###.###........*..........$...++++++.........#
##...........................############.....................++.+.+.+........#
#..*.........................############..................*..+..++.+.+.......#
#.....$$......................###+++#+##......................................#
#.........................*.....+.+.........*........$........................#
##..............*....$.............................*...............*.......$..#
##........##.........*................*.............#####.....................#
##.......#####...................................~########....................#
##......###+###..........................#~...~~~##########.....$.............#
##..$....##+#.................$$....#######~~~...#####+#+#........###.##..*..##
#.......................*..........########...~~~~###............########....##
#..*.................##............#######~~~~................*..#.#++###....##
#...................####.......*......++..............................#......##
#.....$$....*........#+.............................**..........$...........###
#.......................................*.$.................................###
##..###....#######............#######............###....#############...*....##
###############################################################################

