+###############################################################################
######....###############.....################........##....*..##########....###
####...........................................*..............................##
##.......$......................**........................$$...=..=.=.==......##
#....*.......####...........$$..........*.*.......++....*.....=.==..==..*....###
##.........#######..........$...............$$...+==+..........=.=++=.=..$$.####
##..........##+###...*.......................$....++..........=..+++..=.....####
##..*........+++................................................++++.........###
##........*......$$...........##.###.###........*..........$...++++++.........##
##...........................############.....................++.+.+.+........##
#..*.........................############..................*..+..++.+.+.......##
#.....$$......................###+++#+##......................................##
#.........................*.....+.+.........*........$........................##
##..............*....$.............................*...............*.......$..##
##........##.........*................*.............#####.....................##
##.......#####...................................~########....................##
##......###+###..........................#~...~~~##########.....$.............##
##..$....##+#.................$$....#######~~~...#####+#+#........###.##..*..###
#.......................*..........########...~~~~###............########....###
#..*.................##............#######~~~~................*..#.#++###....###
#...................####.......*......++..............................#......###
#.....$$....*........#+.............................**..........$...........####
#.......................................*.$.................................####
##..###....#######............#######............###....#############...*....###
################################################################################


