????????????????????????????????????????????????????????????????????????????????
????????????????????????????????????????????????????????????????????????????????
????????????????????????????????????????????????????????????????????????????????
????????????????????????????????????????????????????????????????????????????????
???????????????????&&???????????????????????*???????????????????????????????????
?????????????????&&&&.......................&&++&&...........*.......&&.........
xxx==............&&&&&.....*...............&&++&+&...........*.....&&&&&........
|||||.......*....&&&&&.....................&&++++&&................&&&&&&.......
|||||.............&&.......................&++++++&..*............&&&&&&&.......
^^^||...............................*......&+.++.+&...............*&&&&&&.......
|||||.........................................++................................
|||||........................................++++...............................
xxx==.......................................++++++..............................
............................&&&&&..........*.............*..................*...
...........................&&&&&&&..............................................
...............*...........&&+&&&&..............................................
...........................&+.+.+&..............................................
.......*...................+..+..+...................................&&....*....
.............................+.+....................*............*...&&&........
.......................*..............*.............................&&&&&.......
??????????????????????????????????????????????????..................&&&&&.......
????????????????????????????????????????????????????????????????????????????????
????????????????????????????????????????????????????????????????????????????????
????????????????????????????????????????????????????????????????????????????????
????????????????????????????????????????????????????????????????????????????????
