################################################################################
#~~~~~~##############~~~~~~~########~~~~~~~~~~###########~~~~###~~~###~~~~~#####
#~~~~~~#########~~~~~~~~~~~~#######~~~~~~~~~~~~######~~~~~~~~~~~~~~#~~~~~~~~~###
###~~~~~~#####~~~~~~~~~~~~~~~~~~~~~~~~~~~~~~~~~#~~~~~~~~~~~~~~~~~~~~~~~~~~~~~~##
###~~~~~~~~~~~~~~~~&&~~~~~~~~~~~~~~~~~~~~~~~*~~~~~~~~~~~~~~~~~~~~~~~~~~~~~~~~~~#
#~~~~~~~~~~~~.~~~&&&&.......................&&++&&...........*.......&&........#
=====............&&&&&.....*...............&&++&+&...........*.....&&&&&.......#
|||||.......*....&&&&&.....................&&++++&&................&&&&&&.....##
|||||.............&&.......................&++++++&..*............&&&&&&&.....##
^^^||...............................*......&+.++.+&...............*&&&&&&.....##
|||||.........................................++..............................##
|||||........................................++++.............................##
=====.......................................++++++............................##
###.........................&&&&&..........*.............*..................*.##
###........................&&&&&&&.............................................#
###............*...........&&+&&&&.............................................#
##.........................&+.+.+&.............................................#
##.....*...................+..+..+...................................&&....*...#
##...........................+.+....................*............*...&&&.......#
##.....................*..............*.............................&&&&&......#
##~~~~~~#####~~~~~~~~~~~~~~~~~~~~~~~~~~~~~~~~~~~~~..................&&&&&......#
##~~~~~~~####~~~~~~~~~~~~~~~~~~~~~~~~~~~~~~~~~~~~~~~~~~~~~~~~~~~~~~~~~~~~~~~~~~#
##~~~~~~#####~~#####~~~~~~~~###~~~~~~~~~~~~~~~~~~~~~~~~~~~~~~~~~~~~~~~~~###~~~~#
####################~~~~~~~########~~~~~~~~~~~~###~~~~~~~~~~~~~~~~~~~~##########
################################################################################