////////////////////////////////////////////////////////////////////////////////
/??????//////////////???????////////??????????///////////????///???///?????/////
/??????/////////????????????///////????????????//////??????????????/?????????///
///??????/////?????????????????????????????????/??????????????????????????????//
///????????????????&&???????????????????????*??????????????????????????????????/
/????????????????&&&&.......................&&++&&...........*.......&&......../
xxx==............&&&&&.....*...............&&++&+&...........*.....&&&&&......./
|||||.......*....&&&&&.....................&&++++&&................&&&&&&.....//
|||||.............&&.......................&++++++&..*............&&&&&&&.....//
^^^||...............................*......&+.++.+&...............*&&&&&&.....//
|||||.........................................++..............................//
|||||........................................++++.............................//
xxx==.......................................++++++............................//
///.........................&&&&&..........*.............*..................*.//
///........................&&&&&&&............................................./
///............*...........&&+&&&&............................................./
//.........................&+.+.+&............................................./
//.....*...................+..+..+...................................&&....*.../
//...........................+.+....................*............*...&&&......./
//.....................*..............*.............................&&&&&....../
//??????/////?????????????????????????????????????..................&&&&&....../
//???????////??????????????????????????????????????????????????????????????????/
//??????/////??/////????????///?????????????????????????????????????????///????/
////////////////////???????////////????????????///?????????????????????/////////
////////////////////////////////////////////////////////////////////////////////
