,*,**,,,,,,,,,,,,,,,*,~~~~~,,,,,,,,,,,,,,,,,,,,,,,,,,**,,*,,,,,,,,,,,,,,,,,,,,,,
*,*,*,*,,,*,,,,*,,*,,,~~~~~,***,,,,*,,,,*,,**,,*,,,,,*,,,,,,,,,,,,,,,*,,*,,**,,,
,****,,**,,,,*,,,*,**,~~~~~,,*,*,,,**,***,*,,*,,,,,,,,,,,,*,***,**,,*,,,,,,,*,,,
*,****,**,*,,,,*,,,,*,~~~~~,,,,*,,,,*,*,,,*,,*,*,,*,,,*,,,*,,,**,,,,*,,*,,,,*,,,
,*,**,,,*,,,,,,,,,*,,,,~~~~~~,*,,**,,,,***,,,*,,,,*,,*,,,,,,,,,*,,,,,,**,*,,,*,,
*,**,*,,*,*,*,,*,,,,*,,,~~~~~,,,*,,**,**,**,,,,,,,,,*,,,**,*,,*,,*,,,*,*,,,*,,,,
,*,*,*,**,,,,,,,,,,,,,*,,~~~~,,,,*,*,,*,*,*,,,***,,*,*,**,,*,**,,*,**,,*,*,*,,,,
*,*,*,,*,,*,,**,*,,*,*,*,~~~~,,*,,*,,,****,,,,*,,,*,,*,,,,*,,*,,,,**,*,*,,,,***,
,*,*,,,,,,,,*,,,****,*,**~~~~,,,,,*,,**,,*,**,,,,,,,,,,,,*,,,*,,,,,,*,*,**,,*,,,
*,*,,*,**,**,,,,,*,*,,,,*,~~~,,,,**,,,,,,,,*,,,,,,,,,,*,,**,,,,*,,,**,,,,*,,*,,*
,***,**,*,,,,*,,,,,,,,*,,,~~~,,,,,*,,,,*,*,*,**,,*,*,,,*,,,,,,,,,,,,*,**,,***,,*
*,**,,,,,,,,**,**,,,,,,,,,,~~~~~,,**,*,,,,,,,,,*,,,,,**,***,*,,,*,,,**,,,,,,****
,*,*,*,**,,*,,,,,,***,,*,,,~~~~~~~,,,,**,,,***,,,,*,*,*,,,,,,,*,***,,,,,*,,,*,,,
,*******,,*,*,,*,,*,,,**,,,~~~~~~~~,,*,,,*,,,,,,,**,,,,,,,,**,*,,,*,,**,**,,***,
**,**,*,,*,*,,,,,,,,,,,,*,*,~~~~~~~,,,**,,**,,,,,,,**,,,,,**,*,,,,**,,,*,,,****,
,****,**,,,,,*****,*,,,,*,,,~~~~~~~~*,*,*,*,,,,,,*,,,,*,,**,,*,,***,,,,,,,**,,*,
**,,*,*,,*,,,,,*,,,,*,,,,,,,~~~~~~~~,**,,,,,,**,,*,,*,*,,*,,,,,,,,,,,,,,*****,,,
,,*,,**,*,*,,,,*,,,,*,,*,,*,,,,~~~~~~~,,*,,,,,,,,,*,*,*,,,*,,,*,,,,**,***,,,*,,,
,*,,,*,,*,,,,,*,,**,*,,,*,***,,,~~~~~~,*,,*,*,,,,,*,,,,,,,*,,,,**,*,,**,***,**,,
,,,*,,,**,,**,,,*,,,*,**,,*,,,*,~~~~~~,,*,*,,,,,,,,,,,,,,*,,,*,*,,,*,,,,*,**,*,,
,,,,,*,*,,*,*,***,**,,,,,*,,*,,,~~~~~~,*,*,,,,*,,*,*,*,,,*,**,,,,,,*,,,,*,,,,**,
,,*,**,*,,*,,,,,,*,,,,,,,,,*,**,,~~~~~,*,*,,,,*,,*,,,,,,,,,,,,,,,*,,,,*,,*,,,*,,
,*,,*,,,,*,,,*,*,*,,,*,,*,*,****,~~~~~,,*,,*,,,,*,,*,*,,,,,,,,,,,*,,*,*,,,****,,
,,,*,,*,*,,,,*,,*,*,,,*,*,*,,*,,,~~~~~,,*,,*,,,,*,,*,*,**,*,,,**,*,,,,,**,,,**,,
,*,,*,*,*,,**,,,*,,*,*,**,***,,*,~~~~~,*,**,,,,,*,,,***,,,**,,,,,,,**,,*,,*,,,,,
