^^^^^^^^^^^^^^^^^^^^^^^^^^^^^^^^^^^^^^^^^^^^^^^^^^^^^^^^^^^^^^^^^^^^^^^^^^^^^^^^
^^^^^^....^^^^^^^^^^^^^^^.....^^^^^^^^^^^^^^^^........^^....*..^^^^^^^^^^....^^^
^^^^...........................................*..............................^^
^^.......$......................**........................$$...=..=.=.==......^^
^....*.......????...........$$..........*.*.......++....*.....=.==..==..*....^^^
^^.........???????..........$...............$$...+==+..........=.=++=.=..$$.^^^^
^^..........??+/??...*.......................$....++..........=..+++..=.....^^^^
^^..*........+++................................................++++.........^^^
^^........*......$$...........??.???.???........*..........$...++++++.........^^
^^...........................????????????.....................++.+.+.+........^^
^..*.........................????//???/?/..................*..+..++.+.+.......^^
^.....$$......................?/?+++/+??......................................^^
^.........................*.....+.+.........*........$........................^^
^^..............*....$.............................*...............*.......$..^^
^^........??.........*................*.............?????.....................^^
^^.......?????...................................~????????....................^^
^^......??/+/??..........................?~...~~~?????/??/?.....$.............^^
^^..$....??+?.................$$....???????~~~...???/?+?+?........???.??..*..^^^
^.......................*..........???/????...~~~~???............?/?/??/?....^^^
^..*.................??............?/??/?/~~~~................*..?.?++/??....^^^
^...................??/?.......*......++..............................?......^^^
^.....$$....*........?+.............................**..........$...........^^^^
^.......................................*.$.................................^^^^
^^..^^^....^^^^^^^............^^^^^^^............^^^....^^^^^^^^^^^^^...*....^^^
^^^^^^^^^^^^^^^^^^^^^^^^^^^^^^^^^^^^^^^^^^^^^^^^^^^^^^^^^^^^^^^^^^^^^^^^^^^^^^^^
